aerodynamics:aircraft:cruise:CD	data:aerodynamics:aircraft:cruise:CD
aerodynamics:aircraft:cruise:CD:compressibility	data:aerodynamics:aircraft:cruise:CD:compressibility
aerodynamics:aircraft:cruise:CD:k	tuning:aerodynamics:aircraft:cruise:CD:k
aerodynamics:aircraft:cruise:CD:offset	tuning:aerodynamics:aircraft:cruise:CD:offset
aerodynamics:aircraft:cruise:CD:trim	data:aerodynamics:aircraft:cruise:CD:trim
aerodynamics:aircraft:cruise:CD:winglet_effect:k	tuning:aerodynamics:aircraft:cruise:CD:winglet_effect:k
aerodynamics:aircraft:cruise:CD:winglet_effect:offset	tuning:aerodynamics:aircraft:cruise:CD:winglet_effect:offset
aerodynamics:aircraft:cruise:CD0	data:aerodynamics:aircraft:cruise:CD0
aerodynamics:aircraft:cruise:CL	data:aerodynamics:aircraft:cruise:CL
aerodynamics:aircraft:cruise:CL:k	tuning:aerodynamics:aircraft:cruise:CL:k
aerodynamics:aircraft:cruise:CL:offset	tuning:aerodynamics:aircraft:cruise:CL:offset
aerodynamics:aircraft:cruise:CL:winglet_effect:k	tuning:aerodynamics:aircraft:cruise:CL:winglet_effect:k
aerodynamics:aircraft:cruise:CL:winglet_effect:offset	tuning:aerodynamics:aircraft:cruise:CL:winglet_effect:offset
aerodynamics:aircraft:cruise:CL_alpha	data:aerodynamics:aircraft:cruise:CL_alpha
aerodynamics:aircraft:cruise:induced_drag_coefficient	data:aerodynamics:aircraft:cruise:induced_drag_coefficient
aerodynamics:aircraft:cruise:L_D_max	data:aerodynamics:aircraft:cruise:L_D_max
aerodynamics:aircraft:cruise:optimal_CD	data:aerodynamics:aircraft:cruise:optimal_CD
aerodynamics:aircraft:cruise:optimal_CL	data:aerodynamics:aircraft:cruise:optimal_CL
aerodynamics:aircraft:landing:additional_CL_capacity	data:aerodynamics:aircraft:landing:additional_CL_capacity
aerodynamics:aircraft:landing:CL_max	data:aerodynamics:aircraft:landing:CL_max
aerodynamics:aircraft:landing:CL_max:landing_gear_effect:k	tuning:aerodynamics:aircraft:landing:CL_max:landing_gear_effect:k
aerodynamics:aircraft:landing:CL_max:landing_gear_effect:offset	tuning:aerodynamics:aircraft:landing:CL_max:landing_gear_effect:offset
aerodynamics:aircraft:landing:CL_max_clean	data:aerodynamics:aircraft:landing:CL_max_clean
aerodynamics:aircraft:landing:mach	data:aerodynamics:aircraft:landing:mach
aerodynamics:aircraft:landing:reynolds	data:aerodynamics:aircraft:landing:reynolds
aerodynamics:aircraft:takeoff:CL_alpha	data:aerodynamics:aircraft:takeoff:CL_alpha
aerodynamics:aircraft:takeoff:CL0_clean	data:aerodynamics:aircraft:takeoff:CL0_clean
aerodynamics:cruise:neutral_point:x	data:aerodynamics:cruise:neutral_point:x
aerodynamics:fuselage:cruise:CD0	data:aerodynamics:fuselage:cruise:CD0
aerodynamics:fuselage:cruise:CnBeta	data:aerodynamics:fuselage:cruise:CnBeta
aerodynamics:high_lift_devices:landing:CL	data:aerodynamics:high_lift_devices:landing:CL
aerodynamics:horizontal_tail:cruise:CD0	data:aerodynamics:horizontal_tail:cruise:CD0
aerodynamics:horizontal_tail:cruise:CL_alpha	data:aerodynamics:horizontal_tail:cruise:CL_alpha
aerodynamics:nacelles:cruise:CD0	data:aerodynamics:nacelles:cruise:CD0
aerodynamics:pylons:cruise:CD0	data:aerodynamics:pylons:cruise:CD0
aerodynamics:vertical_tail:cruise:CD0	data:aerodynamics:vertical_tail:cruise:CD0
aerodynamics:vertical_tail:cruise:CL_alpha	data:aerodynamics:vertical_tail:cruise:CL_alpha
aerodynamics:vertical_tail:cruise:CnBeta	data:aerodynamics:vertical_tail:cruise:CnBeta
aerodynamics:wing:cruise:CD0	data:aerodynamics:wing:cruise:CD0
aerodynamics:wing:cruise:reynolds	data:aerodynamics:wing:cruise:reynolds
geometry:aircraft:wetted_area	data:geometry:aircraft:wetted_area
geometry:cabin:aisle_width	data:geometry:cabin:aisle_width
geometry:cabin:containers:count	data:geometry:cabin:containers:count
geometry:cabin:containers:count_by_row	data:geometry:cabin:containers:count_by_row
geometry:cabin:crew_count:commercial	data:geometry:cabin:crew_count:commercial
geometry:cabin:crew_count:technical	data:geometry:cabin:crew_count:technical
geometry:cabin:exit_width	data:geometry:cabin:exit_width
geometry:cabin:length	data:geometry:cabin:length
geometry:cabin:NPAX1	data:geometry:cabin:NPAX1
geometry:cabin:pallet_count	data:geometry:cabin:pallet_count
geometry:cabin:seat_rows:count	data:geometry:cabin:seat_rows:count
geometry:cabin:seats:business:count_by_row	data:geometry:cabin:seats:business:count_by_row
geometry:cabin:seats:business:length	data:geometry:cabin:seats:business:length
geometry:cabin:seats:business:width	data:geometry:cabin:seats:business:width
geometry:cabin:seats:economical:count_by_row	data:geometry:cabin:seats:economical:count_by_row
geometry:cabin:seats:economical:length	data:geometry:cabin:seats:economical:length
geometry:cabin:seats:economical:width	data:geometry:cabin:seats:economical:width
geometry:flap:chord_ratio	data:geometry:flap:chord_ratio
geometry:flap:span_ratio	data:geometry:flap:span_ratio
geometry:fuselage:front_length	data:geometry:fuselage:front_length
geometry:fuselage:length	data:geometry:fuselage:length
geometry:fuselage:maximum_height	data:geometry:fuselage:maximum_height
geometry:fuselage:maximum_width	data:geometry:fuselage:maximum_width
geometry:fuselage:PAX_length	data:geometry:fuselage:PAX_length
geometry:fuselage:rear_length	data:geometry:fuselage:rear_length
geometry:fuselage:wetted_area	data:geometry:fuselage:wetted_area
geometry:horizontal_tail:area	data:geometry:horizontal_tail:area
geometry:horizontal_tail:aspect_ratio	data:geometry:horizontal_tail:aspect_ratio
geometry:horizontal_tail:distance_from_wing	data:geometry:horizontal_tail:distance_from_wing
geometry:horizontal_tail:MAC:length	data:geometry:horizontal_tail:MAC:length
geometry:horizontal_tail:MAC:x	data:geometry:horizontal_tail:MAC:x
geometry:horizontal_tail:MAC:y	data:geometry:horizontal_tail:MAC:y
geometry:horizontal_tail:root_chord	data:geometry:horizontal_tail:root_chord
geometry:horizontal_tail:span	data:geometry:horizontal_tail:span
geometry:horizontal_tail:sweep_0	data:geometry:horizontal_tail:sweep_0
geometry:horizontal_tail:sweep_100	data:geometry:horizontal_tail:sweep_100
geometry:horizontal_tail:sweep_25	data:geometry:horizontal_tail:sweep_25
geometry:horizontal_tail:taper_ratio	data:geometry:horizontal_tail:taper_ratio
geometry:horizontal_tail:thickness_ratio	data:geometry:horizontal_tail:thickness_ratio
geometry:horizontal_tail:tip_chord	data:geometry:horizontal_tail:tip_chord
geometry:horizontal_tail:volume_coefficient	data:geometry:horizontal_tail:volume_coefficient
geometry:horizontal_tail:wetted_area	data:geometry:horizontal_tail:wetted_area
geometry:landing_gear:front:distance_to_main	data:geometry:landing_gear:front:distance_to_main
geometry:landing_gear:height	data:geometry:landing_gear:height
geometry:propulsion:engine:count	data:geometry:propulsion:engine:count
geometry:propulsion:engine:y_ratio	data:geometry:propulsion:engine:y_ratio
geometry:propulsion:fan:length	data:geometry:propulsion:fan:length
geometry:propulsion:nacelle:diameter	data:geometry:propulsion:nacelle:diameter
geometry:propulsion:nacelle:length	data:geometry:propulsion:nacelle:length
geometry:propulsion:nacelle:wetted_area	data:geometry:propulsion:nacelle:wetted_area
geometry:propulsion:nacelle:y	data:geometry:propulsion:nacelle:y
geometry:propulsion:pylon:length	data:geometry:propulsion:pylon:length
geometry:propulsion:pylon:wetted_area	data:geometry:propulsion:pylon:wetted_area
geometry:slat:chord_ratio	data:geometry:slat:chord_ratio
geometry:slat:span_ratio	data:geometry:slat:span_ratio
geometry:vertical_tail:area	data:geometry:vertical_tail:area
geometry:vertical_tail:aspect_ratio	data:geometry:vertical_tail:aspect_ratio
geometry:vertical_tail:distance_from_wing	data:geometry:vertical_tail:distance_from_wing
geometry:vertical_tail:MAC:length	data:geometry:vertical_tail:MAC:length
geometry:vertical_tail:MAC:x	data:geometry:vertical_tail:MAC:x
geometry:vertical_tail:MAC:z	data:geometry:vertical_tail:MAC:z
geometry:vertical_tail:root_chord	data:geometry:vertical_tail:root_chord
geometry:vertical_tail:span	data:geometry:vertical_tail:span
geometry:vertical_tail:sweep_0	data:geometry:vertical_tail:sweep_0
geometry:vertical_tail:sweep_100	data:geometry:vertical_tail:sweep_100
geometry:vertical_tail:sweep_25	data:geometry:vertical_tail:sweep_25
geometry:vertical_tail:taper_ratio	data:geometry:vertical_tail:taper_ratio
geometry:vertical_tail:thickness_ratio	data:geometry:vertical_tail:thickness_ratio
geometry:vertical_tail:tip_chord	data:geometry:vertical_tail:tip_chord
geometry:vertical_tail:volume_coefficient	data:geometry:vertical_tail:volume_coefficient
geometry:vertical_tail:wetted_area	data:geometry:vertical_tail:wetted_area
geometry:wing:area	data:geometry:wing:area
geometry:wing:aspect_ratio	data:geometry:wing:aspect_ratio
geometry:wing:b_50	data:geometry:wing:b_50
geometry:wing:kink:chord	data:geometry:wing:kink:chord
geometry:wing:kink:leading_edge:x	data:geometry:wing:kink:leading_edge:x
geometry:wing:kink:span_ratio	data:geometry:wing:kink:span_ratio
geometry:wing:kink:thickness_ratio	data:geometry:wing:kink:thickness_ratio
geometry:wing:kink:y	data:geometry:wing:kink:y
geometry:wing:MAC:length	data:geometry:wing:MAC:length
geometry:wing:MAC:x	data:geometry:wing:MAC:x
geometry:wing:MAC:y	data:geometry:wing:MAC:y
geometry:wing:outer_area	data:geometry:wing:outer_area
geometry:wing:root:chord	data:geometry:wing:root:chord
geometry:wing:root:leading_edge:x	data:geometry:wing:root:leading_edge:x
geometry:wing:root:thickness_ratio	data:geometry:wing:root:thickness_ratio
geometry:wing:root:virtual_chord	data:geometry:wing:root:virtual_chord
geometry:wing:root:y	data:geometry:wing:root:y
geometry:wing:span	data:geometry:wing:span
geometry:wing:spar_ratio:front:kink	data:geometry:wing:spar_ratio:front:kink
geometry:wing:spar_ratio:front:root	data:geometry:wing:spar_ratio:front:root
geometry:wing:spar_ratio:front:tip	data:geometry:wing:spar_ratio:front:tip
geometry:wing:spar_ratio:rear:kink	data:geometry:wing:spar_ratio:rear:kink
geometry:wing:spar_ratio:rear:root	data:geometry:wing:spar_ratio:rear:root
geometry:wing:spar_ratio:rear:tip	data:geometry:wing:spar_ratio:rear:tip
geometry:wing:sweep_0	data:geometry:wing:sweep_0
geometry:wing:sweep_100_inner	data:geometry:wing:sweep_100_inner
geometry:wing:sweep_100_outer	data:geometry:wing:sweep_100_outer
geometry:wing:sweep_25	data:geometry:wing:sweep_25
geometry:wing:taper_ratio	data:geometry:wing:taper_ratio
geometry:wing:thickness_ratio	data:geometry:wing:thickness_ratio
geometry:wing:tip:chord	data:geometry:wing:tip:chord
geometry:wing:tip:leading_edge:x	data:geometry:wing:tip:leading_edge:x
geometry:wing:tip:thickness_ratio	data:geometry:wing:tip:thickness_ratio
geometry:wing:tip:y	data:geometry:wing:tip:y
geometry:wing:wetted_area	data:geometry:wing:wetted_area
handling_qualities:static_margin	data:handling_qualities:static_margin
load_case:lc1:altitude	data:load_case:lc1:altitude
load_case:lc1:U_gust	data:load_case:lc1:U_gust
load_case:lc1:Vc_EAS	data:load_case:lc1:Vc_EAS
load_case:lc2:altitude	data:load_case:lc2:altitude
load_case:lc2:U_gust	data:load_case:lc2:U_gust
load_case:lc2:Vc_EAS	data:load_case:lc2:Vc_EAS
mission:operational:alternate_climb:duration	data:mission:operational:alternate_climb:duration
mission:operational:alternate_climb:fuel	data:mission:operational:alternate_climb:fuel
mission:operational:alternate_cruise:distance	data:mission:operational:alternate_cruise:distance
mission:operational:alternate_cruise:duration	data:mission:operational:alternate_cruise:duration
mission:operational:alternate_cruise:fuel	data:mission:operational:alternate_cruise:fuel
mission:operational:alternate_descent:duration	data:mission:operational:alternate_descent:duration
mission:operational:alternate_descent:fuel	data:mission:operational:alternate_descent:fuel
mission:operational:climb:duration	data:mission:operational:climb:duration
mission:operational:climb:fuel	data:mission:operational:climb:fuel
mission:operational:climb:max_climb_rate	data:mission:operational:climb:max_climb_rate
mission:operational:climb:thrust_rate	data:mission:operational:climb:thrust_rate
mission:operational:cruise:altitude	data:mission:operational:cruise:altitude
mission:operational:cruise:duration	data:mission:operational:cruise:duration
mission:operational:cruise:fuel	data:mission:operational:cruise:fuel
mission:operational:cruise:mach	data:mission:operational:cruise:mach
mission:operational:descent:duration	data:mission:operational:descent:duration
mission:operational:descent:fuel	data:mission:operational:descent:fuel
mission:operational:descent:thrust_rate	data:mission:operational:descent:thrust_rate
mission:operational:flight:duration	data:mission:operational:flight:duration
mission:operational:flight:fuel	data:mission:operational:flight:fuel
mission:operational:flight:range	data:mission:operational:flight:range
mission:operational:holding:altitude	data:mission:operational:holding:altitude
mission:operational:holding:CAS	data:mission:operational:holding:CAS
mission:operational:holding:duration	data:mission:operational:holding:duration
mission:operational:holding:fuel	data:mission:operational:holding:fuel
mission:operational:initial_climb:fuel	data:mission:operational:initial_climb:fuel
mission:operational:landing:duration	data:mission:operational:landing:duration
mission:operational:landing:flap_angle	data:mission:operational:landing:flap_angle
mission:operational:landing:friction_coefficient_brake	data:mission:operational:landing:friction_coefficient_brake
mission:operational:landing:fuel	data:mission:operational:landing:fuel
mission:operational:landing:length	data:mission:operational:landing:length
mission:operational:landing:slat_angle	data:mission:operational:landing:slat_angle
mission:operational:landing:thrust_rate	data:mission:operational:landing:thrust_rate
mission:operational:takeoff:altitude	data:mission:operational:takeoff:altitude
mission:operational:takeoff:delta_ISA	data:mission:operational:takeoff:delta_ISA
mission:operational:takeoff:duration	data:mission:operational:takeoff:duration
mission:operational:takeoff:flap_angle	data:mission:operational:takeoff:flap_angle
mission:operational:takeoff:friction_coefficient_no_brake	data:mission:operational:takeoff:friction_coefficient_no_brake
mission:operational:takeoff:fuel	data:mission:operational:takeoff:fuel
mission:operational:takeoff:slat_angle	data:mission:operational:takeoff:slat_angle
mission:operational:takeoff:TOFL	data:mission:operational:takeoff:TOFL
mission:operational:takeoff:V2	data:mission:operational:takeoff:V2
mission:operational:takeoff:VLOF	data:mission:operational:takeoff:VLOF
mission:operational:takeoff:VMCA	data:mission:operational:takeoff:VMCA
mission:operational:takeoff:VR	data:mission:operational:takeoff:VR
mission:operational:taxi_in:duration	data:mission:operational:taxi_in:duration
mission:operational:taxi_in:fuel	data:mission:operational:taxi_in:fuel
mission:operational:taxi_in:speed	data:mission:operational:taxi_in:speed
mission:operational:taxi_in:thrust_rate	data:mission:operational:taxi_in:thrust_rate
mission:operational:taxi_out:duration	data:mission:operational:taxi_out:duration
mission:operational:taxi_out:fuel	data:mission:operational:taxi_out:fuel
mission:operational:taxi_out:speed	data:mission:operational:taxi_out:speed
mission:operational:taxi_out:thrust_rate	data:mission:operational:taxi_out:thrust_rate
mission:sizing:alternate_climb:duration	data:mission:sizing:alternate_climb:duration
mission:sizing:alternate_climb:fuel	data:mission:sizing:alternate_climb:fuel
mission:sizing:alternate_cruise:distance	data:mission:sizing:alternate_cruise:distance
mission:sizing:alternate_cruise:duration	data:mission:sizing:alternate_cruise:duration
mission:sizing:alternate_cruise:fuel	data:mission:sizing:alternate_cruise:fuel
mission:sizing:alternate_descent:duration	data:mission:sizing:alternate_descent:duration
mission:sizing:alternate_descent:fuel	data:mission:sizing:alternate_descent:fuel
mission:sizing:block_fuel	data:mission:sizing:block_fuel
mission:sizing:block_time	data:mission:sizing:block_time
mission:sizing:climb:distance	data:mission:sizing:climb:distance
mission:sizing:climb:duration	data:mission:sizing:climb:duration
mission:sizing:climb:fuel	data:mission:sizing:climb:fuel
mission:sizing:climb:max_climb_rate	data:mission:sizing:climb:max_climb_rate
mission:sizing:climb:thrust_rate	data:mission:sizing:climb:thrust_rate
mission:sizing:cruise:altitude	data:mission:sizing:cruise:altitude
mission:sizing:cruise:distance	data:mission:sizing:cruise:distance
mission:sizing:cruise:duration	data:mission:sizing:cruise:duration
mission:sizing:cruise:fuel	data:mission:sizing:cruise:fuel
mission:sizing:cruise:mass_ratio	data:mission:sizing:cruise:mass_ratio
mission:sizing:cs25:sizing_load_1	data:mission:sizing:cs25:sizing_load_1
mission:sizing:cs25:sizing_load_2	data:mission:sizing:cs25:sizing_load_2
mission:sizing:descent:distance	data:mission:sizing:descent:distance
mission:sizing:descent:duration	data:mission:sizing:descent:duration
mission:sizing:descent:fuel	data:mission:sizing:descent:fuel
mission:sizing:descent:thrust_rate	data:mission:sizing:descent:thrust_rate
mission:sizing:flight:duration	data:mission:sizing:flight:duration
mission:sizing:flight:fuel	data:mission:sizing:flight:fuel
mission:sizing:fuel	data:mission:sizing:fuel
mission:sizing:fuel_reserve	data:mission:sizing:fuel_reserve
mission:sizing:holding:altitude	data:mission:sizing:holding:altitude
mission:sizing:holding:CAS	data:mission:sizing:holding:CAS
mission:sizing:holding:duration	data:mission:sizing:holding:duration
mission:sizing:holding:fuel	data:mission:sizing:holding:fuel
mission:sizing:initial_climb:fuel	data:mission:sizing:initial_climb:fuel
mission:sizing:landing:duration	data:mission:sizing:landing:duration
mission:sizing:landing:flap_angle	data:mission:sizing:landing:flap_angle
mission:sizing:landing:friction_coefficient_brake	data:mission:sizing:landing:friction_coefficient_brake
mission:sizing:landing:fuel	data:mission:sizing:landing:fuel
mission:sizing:landing:length	data:mission:sizing:landing:length
mission:sizing:landing:slat_angle	data:mission:sizing:landing:slat_angle
mission:sizing:landing:thrust_rate	data:mission:sizing:landing:thrust_rate
mission:sizing:takeoff:altitude	data:mission:sizing:takeoff:altitude
mission:sizing:takeoff:delta_ISA	data:mission:sizing:takeoff:delta_ISA
mission:sizing:takeoff:duration	data:mission:sizing:takeoff:duration
mission:sizing:takeoff:flap_angle	data:mission:sizing:takeoff:flap_angle
mission:sizing:takeoff:friction_coefficient_no_brake	data:mission:sizing:takeoff:friction_coefficient_no_brake
mission:sizing:takeoff:fuel	data:mission:sizing:takeoff:fuel
mission:sizing:takeoff:slat_angle	data:mission:sizing:takeoff:slat_angle
mission:sizing:takeoff:TOFL	data:mission:sizing:takeoff:TOFL
mission:sizing:takeoff:V2	data:mission:sizing:takeoff:V2
mission:sizing:takeoff:VLOF	data:mission:sizing:takeoff:VLOF
mission:sizing:takeoff:VMCA	data:mission:sizing:takeoff:VMCA
mission:sizing:takeoff:VR	data:mission:sizing:takeoff:VR
mission:sizing:taxi_in:duration	data:mission:sizing:taxi_in:duration
mission:sizing:taxi_in:fuel	data:mission:sizing:taxi_in:fuel
mission:sizing:taxi_in:speed	data:mission:sizing:taxi_in:speed
mission:sizing:taxi_in:thrust_rate	data:mission:sizing:taxi_in:thrust_rate
mission:sizing:taxi_out:duration	data:mission:sizing:taxi_out:duration
mission:sizing:taxi_out:fuel	data:mission:sizing:taxi_out:fuel
mission:sizing:taxi_out:speed	data:mission:sizing:taxi_out:speed
mission:sizing:taxi_out:thrust_rate	data:mission:sizing:taxi_out:thrust_rate
mission:sizing:trip:fuel	data:mission:sizing:trip:fuel
mission:sizing:ZFW	data:mission:sizing:ZFW
propulsion:altitude	data:propulsion:altitude
propulsion:mach	data:propulsion:mach
propulsion:MTO_thrust	data:propulsion:MTO_thrust
propulsion:phase	data:propulsion:phase
propulsion:required_thrust	data:propulsion:required_thrust
propulsion:required_thrust_rate	data:propulsion:required_thrust_rate
propulsion:rubber_engine:bypass_ratio	data:propulsion:rubber_engine:bypass_ratio
propulsion:rubber_engine:delta_t4_climb	data:propulsion:rubber_engine:delta_t4_climb
propulsion:rubber_engine:delta_t4_cruise	data:propulsion:rubber_engine:delta_t4_cruise
propulsion:rubber_engine:design_altitude	data:propulsion:rubber_engine:design_altitude
propulsion:rubber_engine:maximum_mach	data:propulsion:rubber_engine:maximum_mach
propulsion:rubber_engine:overall_pressure_ratio	data:propulsion:rubber_engine:overall_pressure_ratio
propulsion:rubber_engine:turbine_inlet_temperature	data:propulsion:rubber_engine:turbine_inlet_temperature
propulsion:SFC	data:propulsion:SFC
propulsion:thrust	data:propulsion:thrust
propulsion:thrust_rate	data:propulsion:thrust_rate
propulsion:use_thrust_rate	data:propulsion:use_thrust_rate
requirements:CG_range	data:requirements:CG_range
TLAR:approach_speed	data:TLAR:approach_speed
TLAR:cruise_mach	data:TLAR:cruise_mach
TLAR:max_TOFL	data:TLAR:max_TOFL
TLAR:NPAX	data:TLAR:NPAX
TLAR:range	data:TLAR:range
weight:aircraft:additional_fuel_capacity	data:weight:aircraft:additional_fuel_capacity
weight:aircraft:CG:ratio	data:weight:aircraft:CG:ratio
weight:aircraft:CG:x	data:weight:aircraft:CG:x
weight:aircraft:empty:CG:ratio	data:weight:aircraft:empty:CG:ratio
weight:aircraft:load_case_1:CG:ratio	data:weight:aircraft:load_case_1:CG:ratio
weight:aircraft:load_case_2:CG:ratio	data:weight:aircraft:load_case_2:CG:ratio
weight:aircraft:load_case_3:CG:ratio	data:weight:aircraft:load_case_3:CG:ratio
weight:aircraft:load_case_4:CG:ratio	data:weight:aircraft:load_case_4:CG:ratio
weight:aircraft:LW	data:weight:aircraft:LW
weight:aircraft:max_payload	data:weight:aircraft:max_payload
weight:aircraft:MFW	data:weight:aircraft:MFW
weight:aircraft:MLW	data:weight:aircraft:MLW
weight:aircraft:MTOW	data:weight:aircraft:MTOW
weight:aircraft:MZFW	data:weight:aircraft:MZFW
weight:aircraft:OWE	data:weight:aircraft:OWE
weight:aircraft:payload	data:weight:aircraft:payload
weight:aircraft_empty:CG:x	data:weight:aircraft_empty:CG:x
weight:aircraft_empty:mass	data:weight:aircraft_empty:mass
weight:airframe:CG:x	data:weight:airframe:CG:x
weight:airframe:flight_controls:CG:x	data:weight:airframe:flight_controls:CG:x
weight:airframe:flight_controls:mass	data:weight:airframe:flight_controls:mass
weight:airframe:flight_controls:mass:k	tuning:weight:airframe:flight_controls:mass:k
weight:airframe:flight_controls:mass:k_fc	settings:weight:airframe:flight_controls:mass:k_fc
weight:airframe:flight_controls:mass:offset	tuning:weight:airframe:flight_controls:mass:offset
weight:airframe:fuselage:CG:x	data:weight:airframe:fuselage:CG:x
weight:airframe:fuselage:mass	data:weight:airframe:fuselage:mass
weight:airframe:fuselage:mass:k	tuning:weight:airframe:fuselage:mass:k
weight:airframe:fuselage:mass:k_fus	settings:weight:airframe:fuselage:mass:k_fus
weight:airframe:fuselage:mass:k_lg	settings:weight:airframe:fuselage:mass:k_lg
weight:airframe:fuselage:mass:offset	tuning:weight:airframe:fuselage:mass:offset
weight:airframe:horizontal_tail:CG:x	data:weight:airframe:horizontal_tail:CG:x
weight:airframe:horizontal_tail:mass	data:weight:airframe:horizontal_tail:mass
weight:airframe:horizontal_tail:mass:k	tuning:weight:airframe:horizontal_tail:mass:k
weight:airframe:horizontal_tail:mass:offset	tuning:weight:airframe:horizontal_tail:mass:offset
weight:airframe:landing_gear:front:CG:x	data:weight:airframe:landing_gear:front:CG:x
weight:airframe:landing_gear:front:mass	data:weight:airframe:landing_gear:front:mass
weight:airframe:landing_gear:main:CG:x	data:weight:airframe:landing_gear:main:CG:x
weight:airframe:landing_gear:main:mass	data:weight:airframe:landing_gear:main:mass
weight:airframe:landing_gear:mass:k	tuning:weight:airframe:landing_gear:mass:k
weight:airframe:landing_gear:mass:offset	tuning:weight:airframe:landing_gear:mass:offset
weight:airframe:mass	data:weight:airframe:mass
weight:airframe:paint:CG:x	data:weight:airframe:paint:CG:x
weight:airframe:paint:mass	data:weight:airframe:paint:mass
weight:airframe:paint:mass:k	tuning:weight:airframe:paint:mass:k
weight:airframe:paint:mass:offset	tuning:weight:airframe:paint:mass:offset
weight:airframe:pylon:CG:x	data:weight:airframe:pylon:CG:x
weight:airframe:pylon:mass	data:weight:airframe:pylon:mass
weight:airframe:pylon:mass:k	tuning:weight:airframe:pylon:mass:k
weight:airframe:pylon:mass:offset	tuning:weight:airframe:pylon:mass:offset
weight:airframe:vertical_tail:CG:x	data:weight:airframe:vertical_tail:CG:x
weight:airframe:vertical_tail:mass	data:weight:airframe:vertical_tail:mass
weight:airframe:vertical_tail:mass:k	tuning:weight:airframe:vertical_tail:mass:k
weight:airframe:vertical_tail:mass:offset	tuning:weight:airframe:vertical_tail:mass:offset
weight:airframe:wing:bending_sizing:mass:k	tuning:weight:airframe:wing:bending_sizing:mass:k
weight:airframe:wing:bending_sizing:mass:offset	tuning:weight:airframe:wing:bending_sizing:mass:offset
weight:airframe:wing:CG:x	data:weight:airframe:wing:CG:x
weight:airframe:wing:mass	data:weight:airframe:wing:mass
weight:airframe:wing:mass:k	tuning:weight:airframe:wing:mass:k
weight:airframe:wing:mass:k_mvo	settings:weight:airframe:wing:mass:k_mvo
weight:airframe:wing:mass:k_voil	settings:weight:airframe:wing:mass:k_voil
weight:airframe:wing:mass:offset	tuning:weight:airframe:wing:mass:offset
weight:airframe:wing:reinforcements:mass:k	tuning:weight:airframe:wing:reinforcements:mass:k
weight:airframe:wing:reinforcements:mass:offset	tuning:weight:airframe:wing:reinforcements:mass:offset
weight:airframe:wing:ribs:mass:k	tuning:weight:airframe:wing:ribs:mass:k
weight:airframe:wing:ribs:mass:offset	tuning:weight:airframe:wing:ribs:mass:offset
weight:airframe:wing:secondary_parts:mass:k	tuning:weight:airframe:wing:secondary_parts:mass:k
weight:airframe:wing:secondary_parts:mass:offset	tuning:weight:airframe:wing:secondary_parts:mass:offset
weight:airframe:wing:shear_sizing:mass:k	tuning:weight:airframe:wing:shear_sizing:mass:k
weight:airframe:wing:shear_sizing:mass:offset	tuning:weight:airframe:wing:shear_sizing:mass:offset
weight:crew:CG:x	data:weight:crew:CG:x
weight:crew:mass	data:weight:crew:mass
weight:fuel_tank:CG:x	data:weight:fuel_tank:CG:x
weight:furniture:cargo_configuration:CG:x	data:weight:furniture:cargo_configuration:CG:x
weight:furniture:cargo_configuration:mass	data:weight:furniture:cargo_configuration:mass
weight:furniture:cargo_configuration:mass:k	tuning:weight:furniture:cargo_configuration:mass:k
weight:furniture:cargo_configuration:mass:offset	tuning:weight:furniture:cargo_configuration:mass:offset
weight:furniture:CG:x	data:weight:furniture:CG:x
weight:furniture:food_water:CG:x	data:weight:furniture:food_water:CG:x
weight:furniture:food_water:mass	data:weight:furniture:food_water:mass
weight:furniture:food_water:mass:k	tuning:weight:furniture:food_water:mass:k
weight:furniture:food_water:mass:offset	tuning:weight:furniture:food_water:mass:offset
weight:furniture:mass	data:weight:furniture:mass
weight:furniture:passenger_seats:CG:x	data:weight:furniture:passenger_seats:CG:x
weight:furniture:passenger_seats:mass	data:weight:furniture:passenger_seats:mass
weight:furniture:passenger_seats:mass:k	tuning:weight:furniture:passenger_seats:mass:k
weight:furniture:passenger_seats:mass:offset	tuning:weight:furniture:passenger_seats:mass:offset
weight:furniture:security_kit:CG:x	data:weight:furniture:security_kit:CG:x
weight:furniture:security_kit:mass	data:weight:furniture:security_kit:mass
weight:furniture:security_kit:mass:k	tuning:weight:furniture:security_kit:mass:k
weight:furniture:security_kit:mass:offset	tuning:weight:furniture:security_kit:mass:offset
weight:furniture:toilets:CG:x	data:weight:furniture:toilets:CG:x
weight:furniture:toilets:mass	data:weight:furniture:toilets:mass
weight:furniture:toilets:mass:k	tuning:weight:furniture:toilets:mass:k
weight:furniture:toilets:mass:offset	tuning:weight:furniture:toilets:mass:offset
weight:payload:front_fret:CG:x	data:weight:payload:front_fret:CG:x
weight:payload:PAX:CG:x	data:weight:payload:PAX:CG:x
weight:payload:rear_fret:CG:x	data:weight:payload:rear_fret:CG:x
weight:propulsion:CG:x	data:weight:propulsion:CG:x
weight:propulsion:engine:CG:x	data:weight:propulsion:engine:CG:x
weight:propulsion:engine:mass	data:weight:propulsion:engine:mass
weight:propulsion:engine:mass:k	tuning:weight:propulsion:engine:mass:k
weight:propulsion:engine:mass:offset	tuning:weight:propulsion:engine:mass:offset
weight:propulsion:fuel_lines:CG:x	data:weight:propulsion:fuel_lines:CG:x
weight:propulsion:fuel_lines:mass	data:weight:propulsion:fuel_lines:mass
weight:propulsion:fuel_lines:mass:k	tuning:weight:propulsion:fuel_lines:mass:k
weight:propulsion:fuel_lines:mass:offset	tuning:weight:propulsion:fuel_lines:mass:offset
weight:propulsion:mass	data:weight:propulsion:mass
weight:propulsion:unconsumables:CG:x	data:weight:propulsion:unconsumables:CG:x
weight:propulsion:unconsumables:mass	data:weight:propulsion:unconsumables:mass
weight:propulsion:unconsumables:mass:k	tuning:weight:propulsion:unconsumables:mass:k
weight:propulsion:unconsumables:mass:offset	tuning:weight:propulsion:unconsumables:mass:offset
weight:systems:CG:x	data:weight:systems:CG:x
weight:systems:flight_kit:CG:x	data:weight:systems:flight_kit:CG:x
weight:systems:flight_kit:mass	data:weight:systems:flight_kit:mass
weight:systems:flight_kit:mass:k	tuning:weight:systems:flight_kit:mass:k
weight:systems:flight_kit:mass:offset	tuning:weight:systems:flight_kit:mass:offset
weight:systems:life_support:air_conditioning:CG:x	data:weight:systems:life_support:air_conditioning:CG:x
weight:systems:life_support:air_conditioning:mass	data:weight:systems:life_support:air_conditioning:mass
weight:systems:life_support:air_conditioning:mass:k	tuning:weight:systems:life_support:air_conditioning:mass:k
weight:systems:life_support:air_conditioning:mass:offset	tuning:weight:systems:life_support:air_conditioning:mass:offset
weight:systems:life_support:cabin_lighting:CG:x	data:weight:systems:life_support:cabin_lighting:CG:x
weight:systems:life_support:cabin_lighting:mass	data:weight:systems:life_support:cabin_lighting:mass
weight:systems:life_support:cabin_lighting:mass:k	tuning:weight:systems:life_support:cabin_lighting:mass:k
weight:systems:life_support:cabin_lighting:mass:offset	tuning:weight:systems:life_support:cabin_lighting:mass:offset
weight:systems:life_support:de-icing:CG:x	data:weight:systems:life_support:de-icing:CG:x
weight:systems:life_support:de-icing:mass	data:weight:systems:life_support:de-icing:mass
weight:systems:life_support:de-icing:mass:k	tuning:weight:systems:life_support:de-icing:mass:k
weight:systems:life_support:de-icing:mass:offset	tuning:weight:systems:life_support:de-icing:mass:offset
weight:systems:life_support:insulation:CG:x	data:weight:systems:life_support:insulation:CG:x
weight:systems:life_support:insulation:mass	data:weight:systems:life_support:insulation:mass
weight:systems:life_support:insulation:mass:k	tuning:weight:systems:life_support:insulation:mass:k
weight:systems:life_support:insulation:mass:offset	tuning:weight:systems:life_support:insulation:mass:offset
weight:systems:life_support:oxygen:CG:x	data:weight:systems:life_support:oxygen:CG:x
weight:systems:life_support:oxygen:mass	data:weight:systems:life_support:oxygen:mass
weight:systems:life_support:oxygen:mass:k	tuning:weight:systems:life_support:oxygen:mass:k
weight:systems:life_support:oxygen:mass:offset	tuning:weight:systems:life_support:oxygen:mass:offset
weight:systems:life_support:safety_equipment:CG:x	data:weight:systems:life_support:safety_equipment:CG:x
weight:systems:life_support:safety_equipment:mass	data:weight:systems:life_support:safety_equipment:mass
weight:systems:life_support:safety_equipment:mass:k	tuning:weight:systems:life_support:safety_equipment:mass:k
weight:systems:life_support:safety_equipment:mass:offset	tuning:weight:systems:life_support:safety_equipment:mass:offset
weight:systems:life_support:seats_crew_accommodation:CG:x	data:weight:systems:life_support:seats_crew_accommodation:CG:x
weight:systems:life_support:seats_crew_accommodation:mass	data:weight:systems:life_support:seats_crew_accommodation:mass
weight:systems:life_support:seats_crew_accommodation:mass:k	tuning:weight:systems:life_support:seats_crew_accommodation:mass:k
weight:systems:life_support:seats_crew_accommodation:mass:offset	tuning:weight:systems:life_support:seats_crew_accommodation:mass:offset
weight:systems:mass	data:weight:systems:mass
weight:systems:navigation:CG:x	data:weight:systems:navigation:CG:x
weight:systems:navigation:mass	data:weight:systems:navigation:mass
weight:systems:navigation:mass:k	tuning:weight:systems:navigation:mass:k
weight:systems:navigation:mass:offset	tuning:weight:systems:navigation:mass:offset
weight:systems:operational:cargo_hold:CG:x	data:weight:systems:operational:cargo_hold:CG:x
weight:systems:operational:cargo_hold:mass	data:weight:systems:operational:cargo_hold:mass
weight:systems:operational:mass:k	tuning:weight:systems:operational:mass:k
weight:systems:operational:mass:offset	tuning:weight:systems:operational:mass:offset
weight:systems:operational:radar:CG:x	data:weight:systems:operational:radar:CG:x
weight:systems:operational:radar:mass	data:weight:systems:operational:radar:mass
weight:systems:power:auxiliary_power_unit:CG:x	data:weight:systems:power:auxiliary_power_unit:CG:x
weight:systems:power:auxiliary_power_unit:mass	data:weight:systems:power:auxiliary_power_unit:mass
weight:systems:power:auxiliary_power_unit:mass:k	tuning:weight:systems:power:auxiliary_power_unit:mass:k
weight:systems:power:auxiliary_power_unit:mass:offset	tuning:weight:systems:power:auxiliary_power_unit:mass:offset
weight:systems:power:electric_systems:CG:x	data:weight:systems:power:electric_systems:CG:x
weight:systems:power:electric_systems:mass	data:weight:systems:power:electric_systems:mass
weight:systems:power:electric_systems:mass:k	tuning:weight:systems:power:electric_systems:mass:k
weight:systems:power:electric_systems:mass:offset	tuning:weight:systems:power:electric_systems:mass:offset
weight:systems:power:hydraulic_systems:CG:x	data:weight:systems:power:hydraulic_systems:CG:x
weight:systems:power:hydraulic_systems:mass	data:weight:systems:power:hydraulic_systems:mass
weight:systems:power:hydraulic_systems:mass:k	tuning:weight:systems:power:hydraulic_systems:mass:k
weight:systems:power:hydraulic_systems:mass:offset	tuning:weight:systems:power:hydraulic_systems:mass:offset
weight:systems:power:mass:k_elec	settings:weight:systems:power:mass:k_elec
weight:systems:transmission:CG:x	data:weight:systems:transmission:CG:x
weight:systems:transmission:mass	data:weight:systems:transmission:mass
weight:systems:transmission:mass:k	tuning:weight:systems:transmission:mass:k
weight:systems:transmission:mass:offset	tuning:weight:systems:transmission:mass:offset
